..#.##.#............................#..#....#.........#.#.#...#.........#..#....#..#............
......#....#.....#...#.#.........#.#......##.#.#.#......##.#..............#.#.......#..#.....#..
....#.#...##.#...........#.#.#...#..............#......##.#....#....#.....#........#.......#....
..##...............##.#....#...#..#........#...##........#.....#...#.##....#..................#.
..#...#..............##.#..#..#..#.....#.......#.##.#.......#.#.....#...#.......#...#...#....#.#
##...........#.#..#.......##..#..........##.#.......#.###....#........#.........#....#.....##.#.
.#....#.....#...##......#.#..#.....##....#.....#.........#..#...#.........#....##.#....##.......
........#...#......#..#.##.#...##.#..#........#.#........#..........#..............#.#.....#....
.#........#....#........#..........#............#...#...#..#..............#..............##...##
#.#.#.#....#...#...........##..#..............##.....................##.....................#...
..........#......#..........#..#.#.#.##.#....#..........##..................##.##.#.......#....#
.......#.....#.......#.#..###....#.#..............#.....#....#..#...........#......#...#......#.
.#..................#........#..#....#.........#.......###..#......#.....#..#....#.#.###........
#.....#.........#..........##.#...##...##......##..#.#.#.#..#.....#...##...................#..#.
........##.........#...#..#..............#......#....#..#....##.........................#....#..
#....#.............#.............#.............#.................##...#..###...........#.#.....#
...##.##...##..#..#...#..........#..........................#.....#...................#...#....#
..#....#.#.#.##...#.......#.##..##.#...........#......#.###....###.#...........#....#...........
..#.#.#..#.#..............#.#...##.............#.........###.....#.#.............#..............
.....#....................###..#..........#.....###.....####......#..#........#.......#.........
....#..#...#........#.......#....###......#.....##.......#......#.#.......##............#.......
..#.......#.#.....#..........#......#..#..#####.#.#..##.............##..........#...............
#......#....##..........#.#.#.##.#........#.............#......#..#....#.................##..##.
....###.#..#..................#.##...##....#........##.......#.....#...#...##...#...#.#.#..##...
.#....#.#......................##....#.........#..#...#..#....#.#..###.#..............#..#...#..
....#......#.......#.#.........#..........#...........#..##..#....#....#.#....##.#.#...........#
.#.........#.....#...#........#....#..#....#...###...............#......#.........#....##.......
.#...#......#..#..........#.#.......#......#.#...#..##.........#..#.#......###...##.......#.#...
...###..#...#.#................#.##.#....###...#..........#....#..##..#.......#...###..#.#......
#..........#....###...#.....##..##..##.#...##......#......#.......####.##.......##....#.#..#....
....#..#.##........#.#..........##.#..#.##.....#.#.................#####...##......#..##........
#.#........#....#..#...........#.#.#......##...#.#.........#.......#.......#...#....##..#......#
.......##.####.#.....#...#.#....#..........####..#....#...#......##......#.#.........#..........
.#..#.......#.........#.......#.....#.....##...#..##..............#.#.#.##.#.#.....##.#.##....##
..##..#.#.#.##..#....#.........###.....#..#................#.....##...#..#............##.#......
....#...#...#.........#.........#...#...#..........#...#.##........#.#.....##..#............#.##
.......##.##.#............#.##..##...##....#.....#......#.........#...........#.......##..#.....
.........#........#........#....#.........#...#.#......#...#......#......#...........#......#...
..........#..#...........#...#.........#...#..#...........##.#.......#...#......#.#..#.#........
.........##......#.....................###.##...##...#..............#.#........#.#...#..........
..........#...#..........#...#.##......##.##..##......#.#...#..#......#.........###...#......#..
.#..#...##...##....##.......#....#...#..#...................##....#..#.....#..##..#........#..#.
...#.......#....#...#.##....#..###..#......##.##....#.#...##........#..........................#
......#..........##.#..#...........#.#.#.....#....#..##....#....#.......##..#...#....#.......#..
#................#.#........................#......#..........#.#....##..#..##.............#.#..
..#...#.........#.#...#...#......#..###...........#...#.#.............#....#....................
.#.###..........#.............#...#..#....#..##...#......#....#....#.##........#..........##....
.........#...........#..............####......#.#....#.#...#.#.#...#.#.........#........#...##..
..#.#....#....#..#............##....#.....#...#.............##.#.....#........#........#....#...
.#....#....#.....#...#......#...#...#....##...#....#....##................#.................#...
...........#.#........#..##..............#.........##...........#....#....#..#.#.#.#.#...#......
.#.....#......###.....#........###..#...#.#...........#.............#.#........#........##..#...
...#...#......##.........#...........#...#....###..#.#....##.#.....#..##............#..#..#....#
#.......#......#.#.#.............#..###..#..#....##....##.....#.#.....##...............#.....#..
..................#................##.....#.................#.#......#..#.#.............#.#.....
#......##..#...#...#..#.#....#............#..#.....##.##.....#......#..##.#....#..#....#.#.##.#.
#..#.....#....#....................#....##.....#.#....#...#..........#....#....#................
.....#..#..###.....#.......#.#......#....#.#...........##......#...#.#....#.#........#..#.......
..#..#.##.#..........................#.#.......................##.#..#........#...........#.....
##..........#.............#.#.#..#...##..#.........##....#...#.....#...#.#.......#.....#.#.#....
.....#....#..##.......#..#......#..#.#...##.##....#......#...##.....#..###....#....#.#.....#....
......#......#.#...#.#..#...##.#....#....##.............#......#..#..............#........#.##..
.......#.##....#...#.......#........#.#..#.#.....#..#.#......#................#..#.#.#......#...
..#...#...#..##.......#..#.#....#.........#.....#............#.#....#...#.....##.....#........#.
.......#.....##.#......#.......#.#...#...#.........#..#..#..............##...##.#..........#...#
.........##............#...###..#........#.#..............#..#..##......####...#..#.....##......
.#.........#...#......#.#.....#####.......#.......#.#....#...#...#.#....#....#....#...#....#..#.
.............#.#.#...#.........#.#.......####....####...#.........###.........#..#.....#.#.#..#.
#.......#......#......#.##......#.#....#..#.#.#...........#.......###............#..#.#...#..#..
.........#.............#...............#........#.#....#...#.......##.###......#..#.#.#.#....#..
....#...................##...#.#.........#.#...#...#..##..#..#..#.###....#...........#.#...#...#
.#...##..#..#....#......##...#..#...#.....#..........#.#..#....#.#.......#.#....#.#.#..#.#......
.#.##...#.#.......#.....#.......#......#....#...#.##....#.#..#.....###..#.........#............#
..#........#.......#........#..#......#.....#.............#..#..#.#....#.......##..#...#..##....
.#...##...##.........##...###...#..#.........#.....#.#....###......#....#..###......#.####......
..............#..##....#.#...##....#...#..............#.#..#...##.#...#.#.#....#...........#.#.#
.............#....#.#..###.....#...####.#..#....#....##...#...##.#..#..###......#..........#..##
........##...#...#...#...###...##......#.............#.#..........#......###.......#..#.#....#..
#.##........#..#........##.#..#.##.....#.##....#.....#....#...........#..##....#.#.....#...#....
..........##.#...#......#....##.###...#..##........#......#........###..#.....#.#......#.##.....
#................##.....#..............##...#......###...#.#......................#...#.........
....#....#........#.#..#..............#..#.......#.##.#....#..#.#.#.....#...#....#.#..#.......#.
...........#.........##...............#.#...#..#.#....#...##...###.....#...#...#.........#...#.#
.#.......#...#.............#..#....#.#.##.#..........#.#.....#...##...#.....#..#......#...##....
...##...............#.........###..#...#.##.....#.##..#...#..##.....#..#.#.........#..##....#.#.
#......#...#..............#..#...#..#.#.#...#.#..#..#.....###.##.........##....#..#..#.#....#...
...#.#....#....#.....##..###..........#............#.#.....#....#.#........##......#..#..#....#.
...#.#.......#........###...##.#..#..#.#....#......##.##...##..##.....#...#.###............#....
#........#...#...........###....#...#.#..#..#....#...###.#.#...........#..##.##...#...#.###..##.
#..............#...#........#.#.#...#..#..#.#......#..##.................#.#.......#..#........#
.##...#....#.#....#.#...#.......#.#....##......#.....#............#.#.........#.#...#.##....#...
.........#.....#......#..#............##......#...#..........#.#......#.#..#.....#.#...##.......
..#.#.#.#..##........#..##...#..........#..#...........#...#...##.......#....##........##..#.#..
.#.....#.......##......###...#.##......#.#...##..#....#..##......#........#...#.................
#.##....#.....#..#..##.......#..........#..#....#.....#.#.#..........#..#......#...###....#....#
.......#......#.....#..................#.....#......#..##...##...#....#........#........###.....